Jakarta -

Pemantauan hilal selalu dilakukan untuk menentukan awal bulan Ramadhan. Kementerian Agama (Kemenag )akan menggelar sidang isbat pada Senin, 12 April 2021.

Sebelum menggelar sidang, Kemenag nantinya akan memberikan paparan mengenai pantauan hilal atau penampakan bulan yang dilakukan di berbagai titik di Indonesia.

Direktur Urusan Agama Islam Kemenag, Agus Salim menyatakan pihaknya akan menurunkan sejumlah pemantau hilal di 86 lokasi yang tersebar di 34 provinsi di Indonesia.

Nantinya, hasil pemantauan hilal dan Data Hisab Posisi Hilal awal Ramadan akan dimusyawarahkan dalam sidang isbat. Hal itu bertujuan supaya pemerintah bisa mengambil keputusan penentuan kapan ibadah puasa dimulai.

Baca juga: Ramadan Tahun Ini, Pemerintah Bolehkan Salat Tarawih dan Idul Fitri

1. Daerah Istimewa Aceh: Observasi Tgk. Chiek Kuta Karang Lhoknga Aceh, Lhokseumawe Bukit Blang Tiron Perta Gas Arun, Aceh Jaya Gunung Cring Crang, Aceh Barat Pantai Suak Geudeubang, Aceh Selatan, Pantai Lhok Keutapang, Simeule Panatai Teluk Dalam, Sabang Tugu "0" KM.

2. Sumatra Utara: Rooftop Gedung BMKG Wilayah Sumatera dan OIF UMSU Medan

3. Sumatra Barat: Gedung Kebudayaan Provinsi Sumatera Barat di Kota Padang

4. Riau: Pantai di Kota Dumai

5. Kepulauan Riau: Cafe Puncak, Tanjungpinggir, Pantai Pelawan Pangke, Tugu Khatulistiwa Desa Metunda, Pantai Teluk Buton Desa Teluk Buton Bunguran Utara, Masjid Agung Baitul Ma'mur Anambas.

6. Jambi: Hotel O Duo Weston Kota Jambi

7. Sumatra Selatan : Rafah Tower UIN Raden Fatah Palembang

8. Bangka Belitung: Pantai Tanjung Raya Penagan, Pantai Tanjung Kalian Muntok, Pantai Tanjung Pendam Belitung

9. Bengkulu: Mes Pemda Prov.Bengkulu

10. Lampung: POB Bukit Gemulai, Pantai Canti Rajabasa Kalianda Lampung Selatan, Pantai Jukung Pesisir Tengah, Krui Pesisir Barat

11. DKI Jakarta: Gedung Kantor Wilayah Kementerian Agama DKI Jakarta Masjid Al-Musyariin Basmol Jakarta Barat, Pulau Karya Kepulauan Seribu, dan Masjid KH Hasyim Asy'ari Jakarta Barat

12. Banten : Mercusuar Cikoneng, Banten

13. Jawa Barat: Bosscha Lembang, Subang Astahana Pondok Bali, Cirebon Pantai Gebang, Banjar Gunung Babakan, Tasik Pantai Cipatujah, Garut Pantai Santolo, Sukabumi Pelabuhanratu Cibeas, Simpenan, Imah Noong Lembang Bandung Barat

14. Jawa Tengah: Masjid Agung Semarang

15. DI. Yogyakarta: Bukit Syech Bela Belu Parangtritis Yogyakarta

16. Jawa Timur: Pantai Tanjung Kodok Lamongan, Bukit Banyu Urip, Tuban, Lapan Kabupaten Pasuruan Gunung Sekekep Ponorogo, Kepanjen Kabupaten Malang, Pantai Serang Kabupaten Blitar, Pantai Srau Pacitan, Bukit Wonotorto Blitar, Pantai Nyamplong Kobong Jember, Pantai Pecinan/Pantai Kabut Situbondo, Pantai Pancur Banyuwangi, Pantai Ambat Pamekasan, Bukit Condrodipo Gresik, Pantai Gerbang Bangkalan, Bukit Wonocolo Bojonegoro, Gunung Pandan Madiun, Pantai Kalisangka Kagean, Pantai Bawean Gresik, Menara Hilal Mambaul Maarif, Bukit Gumuk Klasi Banyuwangi, Pantai Taneros Sumenep, Pantai Watukarong Pacitan, Pantai Duta Probolinggo, PP Baitul Hikmah Kota Pasuruan, Pelabuhan Tanjung Tembaga Kota Probolinggo

17. Bali : Pantai Patra Jasa Tuban Kuta Badung

18. Nusa Tenggara Barat : Pantai Loang Baloq Ampenan Mataram

19. Nusa Tenggara Timur : Rooftop Aston Hotel Kupang

20. Kalimantan Barat : Pantai Indah Kakap Kabupaten Kubu Raya

21. Kalimantan Tengah : Menara Masjid Raya Darussalam Palangka Raya

22. Kalimantan Selatan : Lantai Atas Bank Kalimantan Selatan

23. Kalimantan Timur: Tempat Menara Asmaul Husna Masjid Baitul Muttaqin Islamic Center Samarinda

24. Kalimantan Utara : Gunung KNPI Kec. Tanjung Selor

25. Sulawesi Utara : Manado MTC lantai R1

26. Gorontalo : Pantai Wisata Botu Didingga Desa Dambalo Kecamatan Tomilito Kab.Gorontalo Utara

27. Sulawesi Tengah : Gedung Hisab Rukyat Desa Manara Kecamatan Sindue Kabupaten Donggala

28. Sulawesi Barat : Tanjung Mercusuar Sumare, Simboro Kabupaten Mamuju

29. Sulawesi Selatan : Rooftop Mall GTC Tanjung Bunga Makassar

30. Sulawesi Tenggara : Panatai Wolulu Kelurahan Wolulu Kecamatan Watubangga Kabupaten Kolaka

31. Maluku : Desa Wakasihu Kec. Leihitu Barat Kab. Maluku Tengah

32. Maluku Utara: Pantai Rua Kota Ternate, Pantai Supu Kabupaten Halmahera Barat

33. Papua Barat: Pantai Masni, Hotel Kriyad Lantai 8, Bandara Utarum, Masjid Al Hidayah

34. Papua : PLTD Holtekam Distrik Muara Tami Kota Jayapura, Provinsi Papua

Baca juga: Catat! Hari Libur dan Cuti Bersama Idul Fitri 2021

		

Simak Video "Sah! Idul Fitri 1442 H Jatuh Kamis 13 Mei 2021 "
 [Gambas:Video 20detik]
         (elk/elk)                               				sidang isbat				hilal				ramadan 1442                                                 